1111111111111
1E000001C0001
100C001111001
1P0100C000001
1111111111111