1111111111111
1E01100C00001
1000011111001
1P0011001C001
1111111111111