1111111111111
1E011001C0001
100C001111001
1P00110010001
1111111111111