1111111111111
1E000001C0001
100C001100001
1P01000000001
1111111111111